####################
#                  #
#   #    ###   P   #
#  ##              #
#      X    ##     #
#              #   #
#      ##      #   #
#    ##   O     #  #
#         ##     ###
####################
