####################
#                  #
#   #    ###   P   #
#  ##              #
#          ##      #
#              #   #
#      ##      #   #
#    ##   O     #  #
#  X      ##     ###
####################
