####################
#                  #
#   #    ###   P   #
#  ##              #
#          ##      #
#              #   #
#      ##      #   #
#   X##   O     #  #
#         ##     ###
####################
